#============================= UI
xorg : Serveur graphique
pulseaudio : Serveur audio
picom : Compositeur
i3 : Gestionnaire de fenêtres
i3block : Status bar
jgmenu : Launcher
lightdm : Log/Lock screen

#============================= GESTION SYSTÈME
ncdu : Nettoyage système
neofetch : Informations système
intel-gpu-tools : Outils GPU Intel

ntp : Synchronisation horaire
light : Luminosité
redshift : "Mode nuit"
qt5ct: Apparences qt5
numlockx: Num lock

#============================= TERMINAL
terminator : Invite de commande
bash-completion : Auto-complétion bash
most : Man en couleurs

#============================= DÉVELOPPEMENT
git : Gestionnaire de version
make : Gestionnaire de build
clang : Compilateur C/C++
nodejs : Environnement d'exécution JavaScript
npm : Gestionnaire de paquets Node.js
gawk : GNU awk
jq : Traitement JSON

libtool-bin : Support bibliothèques partagées
libxt-dev : Développement X11 (bibliothèques)
libpython3-dev : Développement Python (bibliothèques)

#============================= CLIENTS
firefox-esr : Navigateur web
curl : Client HTTP
ftp : Client FTP

#============================= MISC
xclip : Presse-papier
bc : Calculatrice
scrot : Capture d'écran
zip : Achives ZIP
